level: 1
WWWWWWWWWWWWWWWWW
WP  BB  WBB B  EW
W W WWWBW WBWWW W
W W       W B   W
W W WWW WWWBWWW W
W  B  W B     W W
W W WBW WWWBWWWWW
W B W      B    W
WWWWW WWW WWW W W
WB BB   W  B  B W
WBW WBW WWW WWW W
W      B   BWB BW
W W WWWBW WBWWW W
WE      WB   B EW
WWWWWWWWWWWWWWWWW
