level: 5
WWWWWWWWWWWWWWWWW
WP BB BBW  BB  EW
W WWWBWWWBW WBW W
WBB BBW BB BB BBW
W WWW WWW WWWBWBW
WB BW B BB BB B W
WBWWWBWBWWWBWWWWW
W WB BB BB  BB BW
WWW WWW WWWBWWW W
WB BB B WBWBWBWBW
W WWWBWBWBWWW W W
WB B B BB B BB BW
W WWW W WWWBWWW W
WE BB BBW BB B EW
WWWWWWWWWWWWWWWWW
