level: 1
WWWWWWWWWWWWWWWWW
WP  B   WB  BB EW
W WWW WWW W WWW W
W B     B   W B W
W W W W WWW WWWBW
W             BBW
W W WWWBWWW WWWWW
WB     B  WB    W
WWW WWW WWW WWW W
WB  WBW W      BW
WBWWWBW WWW W W W
W WBB  B   BB WBW
W W WWW WWW WWW W
WE BB B W  B B EW
WWWWWWWWWWWWWWWWW
