level: 2
WWWWWWWWWWWWWWWWW
WP  B B W BB   EW
W WBWWW WWW WWW W
W BB  B   W    BW
WBW WWW WWW WWW W
WBB W       B   W
W WWW W WWW W WWW
W B       BB B BW
WWWBWWWBWWWBW WBW
WBW B WB BB W   W
W WBWWW WWW WWW W
WBB   BBW   B W W
W W WBW WWW WWW W
WE BB  BWB B B EW
WWWWWWWWWWWWWWWWW
