level: 1
WWWWWWWWWWWWWWWWW
WP  B   W   B  EW
W W WWWBW WWWBW W
W     B B B  BW W
W W WWWBW W WWWBW
WB   BW  B  W  BW
W W WWWBWWW W WWW
W W B     W B  BW
WWWBW WBWWW WWW W
W       B BB B BW
W W WWW WWW WWW W
W   W   W      BW
W W WWW WWW WWW W
WE B    WB  BB EW
WWWWWWWWWWWWWWWWW
