level: 1
WWWWWWWWWWWWWWWWW
WP  BB  WB  B  EW
W W WWW W WWWBW W
W  B   BB    B  W
W W WWW WWWBWWW W
W BBW   W  BB   W
W WWWBWWW WWWBWWW
W W  BB   B     W
WWW WWW WWW WWWBW
W  BB  B  B BBW W
W W WBWWW W WWW W
W     W   W W   W
W W W W WWW WWW W
WE  B  BWB     EW
WWWWWWWWWWWWWWWWW
