level: 1
WWWWWWWWWWWWWWWWW
WP B B  W   B  EW
W W WWW W WWWBW W
WB  W   W W   W W
W W WWW WBW WWW W
W W  BW    B    W
WBWWW W WWW W WWW
WB  B           W
WWWWWBW W WBWWW W
WB  BB BB  B BB W
W WWW WWW WWW WBW
W B   BB  BBW B W
W WWWBWBWWW WWW W
WE      W      EW
WWWWWWWWWWWWWWWWW
