level: 1
WWWWWWWWWWWWWWWWW
WP    B W   B  EW
W W WWWBWWW WWW W
W B W W B B   WBW
WBWWW WBW WWWBWBW
W       B B W   W
W WBWWW WWWBWWWWW
WB   B       B  W
WWW W WWW WBWWWBW
W  B    W WB B BW
W WWW WBW WWW W W
W W          B BW
W WWW W WWW WWW W
WE      W B BB EW
WWWWWWWWWWWWWWWWW
