level: 1
WWWWWWWWWWWWWWWWW
WP      W  B B EW
W WBWWW WWWBW W W
W WBW  BB    BB W
W W WWW WWW WWW W
W BB          B W
WBWWWBWBWWW WWWWW
W BB  WB    W   W
WWWWW W WWW WWWBW
WB     B BW     W
W WBWWWBWWW WWW W
W B     W  BB WBW
W W W WWW WWW W W
WE      WB  B  EW
WWWWWWWWWWWWWWWWW
