level: 1
WWWWWWWWWWWWWWWWW
WP   BB W B BB EW
W WBW W WWW WWW W
W B    BW    B  W
W WWW W WWW WWW W
W WB          BBW
W WWW WWW WWW WWW
WBB W BB  B    BW
WWW WWW WBWWW W W
W BB  W   W BB  W
W WWW WWW WWW WBW
W BB  B     WBW W
W W W WBWWW WWW W
WE    B W      EW
WWWWWWWWWWWWWWWWW
