level: 1
WWWWWWWWWWWWWWWWW
WP B B  WB  B  EW
W WBW W WWW WWW W
WB  BBWBB BB  W W
W W W WWWBWWW W W
W B BB  W     B W
W W WWW WWW WWWWW
W  BW B      B  W
WWWWW WWW WWW W W
W W      BWBW  BW
W WWW W WBW WWW W
W BB    B       W
W W WWWBW WBWWW W
WE     BW      EW
WWWWWWWWWWWWWWWWW
