level: 1
WWWWWWWWWWWWWWWWW
WP B B BW   B  EW
W WWWBWBW WBWWW W
WB B      WBW   W
W W WWW WWW WWW W
WB    W BB  B   W
W W WBWWW WWW WWW
WBW  B  W B     W
WWW W WBWWW WWW W
W B W  B  B     W
W W WWW WWW WWW W
W  BB  B B    W W
W W W WWW W WWW W
WE      WBB BB EW
WWWWWWWWWWWWWWWWW
