level: 1
WWWWWWWWWWWWWWWWW
WP B   BWB  B  EW
W W W WWW WWW W W
WB       BW B   W
W WBWWW WWW WWW W
W WB      B   WBW
W WWW WWW WBWWWWW
W B  BW B BBW B W
WWWBWWW WBWWW W W
W   W   B    B BW
W W WWWBWWW WWWBW
W B  B  W   B   W
W WWW W W WWW W W
WE  B   W B    EW
WWWWWWWWWWWWWWWWW
