level: 1
WWWWWWWWWWWWWWWWW
WP      W  B   EW
W WWWBW WWW WWW W
W      B B BW  BW
W WWW W WWWBWBW W
W BB     BW    BW
W W WWW WBWWW WWW
W B    BW       W
WWW WWW WBWBWWW W
W WBW BB  BB BB W
W WWW W W WWW W W
W  B  W      BW W
W WBW WWWBWWW W W
WE  B  BW      EW
WWWWWWWWWWWWWWWWW
