level: 1
WWWWWWWWWWWWWWWWW
WP     BW    B EW
W W WWW WWW WWW W
W B   B WBB   B W
W WWW WWW WBWWW W
WBW  BW   B W   W
WBWWWBWBW WWWBWWW
W  BW      B BW W
WWW WWW WWWBWWW W
W    B  B W BB  W
W W WWW WBWBWWW W
W    B    BB    W
W W WWW WWW WBW W
WE    B W      EW
WWWWWWWWWWWWWWWWW
