level: 1
WWWWWWWWWWWWWWWWW
WP      W      EW
W WBW W WWWBWWW W
W  B  W    B   BW
W W WBW WWW WWW W
WB B  B W    BW W
WBW WWW WWWBWWWWW
W W W B   W WBB W
WWWWW WWW WBWBW W
WB     B       BW
WBWWW WWWBWWW W W
W      BB       W
W W WWW WWWBWBW W
WE  B B W  B B EW
WWWWWWWWWWWWWWWWW
