level: 1
WWWWWWWWWWWWWWWWW
WP BB  BW B B  EW
W W WWW WWW WWW W
W BB  B    B  WBW
W W WWW WWW WWW W
W W B W     B   W
WBW WWWBWWW WWWWW
WB   BB B     B W
WWW WBW WWW WWW W
W   W B W WBW  BW
W WWW W W WWW W W
W B  BB     B  BW
W WWWBW WWW WWW W
WE B    W      EW
WWWWWWWWWWWWWWWWW
