level: 3
WWWWWWWWWWWWWWWWW
WP  B BBWBB BB EW
W WWW WWWBWWWBW W
W WBB WBB B   BBW
WBWBWWWBWWW WWWBW
W   B B B   W   W
W WBWWW WWWBWWWWW
WB BWB    BB  BBW
WWW WWW WWW WWW W
W BB   B  W  BW W
WBWBWWWBWWW WWW W
W B B B WB     BW
W W WWW WWWBWBW W
WE   BB W B  B EW
WWWWWWWWWWWWWWWWW
