level: 1
WWWWWWWWWWWWWWWWW
WP      W    B EW
W WBWBWBWWW WWW W
W      BWBW     W
W W W WWW WWW WBW
WBW  B     B   BW
WBW WWW WWW WWWWW
W    BW  B      W
WWWWW WWWBW WBW W
W B B   B B W   W
W W WWW WWWBW W W
WB BW    B  BBW W
W WWW W WWW WWW W
WE B B  W   BB EW
WWWWWWWWWWWWWWWWW
